8 8 8 5 2 2 0 0 2 1 1 1 1 1 1 1 0 0 0 0 0 0
8 8 8 5 4 2 0 0 0 0 0 0 2 1 1 1 1 1 1 1 0 0 0 0 0 0
8 8 8 5 2 2222 0 0 2222 1 1 1 1 1 1 1 0 0 0 0 0 0
8 8 8 5 6 4132 0 0 0 0 0 0 0 0 0 0 2314 1 1 1 1 1 1 1 0 0 0 0 0 0
8 8 8 5 3 24444 0 0 0 4444 2 1 1 1 1 1 1 1 0 1 0 1 1 1
8 8 8 5 4 0 111 333 444 111 333 444 0 1 1 1 1 1 1 1 0 0 0 0 0 0
8 8 8 5 3 4132 0 0 0 0 4312 1 1 1 1 1 1 1 1 1 1 1 1 1
8 8 8 5 4 0 111 444 333 111 444 333 0 1 1 1 1 1 1 1 1 1 1 0 1 1
8 8 8 5 3 0 424242 0 444 0 222 1 1 1 1 1 1 1 0 0 0 0 0 0
8 8 8 5 7 2 2 2 2 2 0 1111 2 2 2 2 2 1111 0 1 1 1 1 1 1 1 1 0 0 1 1 1
8 8 8 5 3 0 331311 0 111 0 333 1 1 1 1 1 1 1 1 0 1 0 1 1
8 8 8 5 7 4444 4444 4444 0 0 0 0 0 0 0 0 4444 4444 4444 1 1 1 1 1 1 1 0 1 0 0 1 0
8 8 8 5 6 2134 0 2134 0 2134 0 0 4312 0 4312 0 4312 1 1 1 1 1 1 1 1 1 1 1 1 1
8 8 8 5 4 0 4422 2424 0 4444 0 0 2222 1 1 1 1 1 1 1 0 1 0 1 1 1
8 8 8 5 6 2222 33 3 3 33 0 0 33 3 3 33 2222 1 1 1 1 1 1 1 0 0 1 1 1 1
8 8 8 5 6 333333 0 0 0 0 0 3 3 3 3 3 3 1 1 1 1 1 1 1 0 0 1 0 1 0
8 8 8 5 7 0 2 2 2 2 2 0 0 0 0 0 0 0 22222 1 1 1 1 1 1 1 0 0 0 1 1 0
8 8 8 5 5 313 33313 1313 133 0 31 3331 131 1 33333 1 1 1 1 1 1 1 1 0 1 0 1 1
8 8 8 5 7 0 0 222 2 0 0 22 222222 0 0 0 0 0 0 1 1 1 1 1 1 1 0 0 0 1 1 0
8 8 8 5 7 0 2 23 2 23 2 3333 333333 2 2 2 2 2 0 1 1 1 1 1 1 1 0 0 1 1 1 1
8 8 8 5 7 3 44 3 444 3 44 44 344 0 3444 0 0 34444 0 1 1 1 1 1 1 1 0 1 1 0 1 1
8 8 8 5 7 3333 1 0 1 0 0 1 1 3 1 3 3 1 3 1 1 1 1 1 1 1 1 0 1 0 1 1
8 8 8 5 7 244 0 0 0 24 0 0 0 44 0 2 0 4 2 1 1 1 1 1 1 1 0 1 0 1 1 1
8 8 8 5 7 0 42 0 224 2424 42 4 222222 0 0 0 0 0 444444 1 1 1 1 1 1 1 0 1 0 1 1 1
