7 8 8 5 2 1 0 0 1 1 1 1 1 1 1 1
8 8 8 5 2 1 0 0 1 1 1 1 1 1 1 1
3 8 8 5 2 1 0 0 1 1 1 1 1 1 1 1
5 8 8 5 2 1 0 0 1 1 1 1 1 1 1 1
2 8 8 5 2 1 0 0 1 1 1 1 1 1 1 1
1 8 8 5 2 1 0 0 1 1 1 1 1 1 1 1